#######E########E####################
# ### #   ###### #    #     #     # E
# ### ### #      #  #    #     #    #
# ### # # # ###### ##################
#            #       #    #   #   # #
#  # ##      # ##### #  # # # # # # #
#  #         #   #   #  # # # # #   #
#  ######   ###  #  ### # # # # ### #
#  #    #               #    #  #   #
#  # ## ########   ## ###########   #
#    ##          ###                #
# ## #############  ###   ####   ## #
#  ### ##        #   #  #           #
#  #   ## ####     #    #      ###  #
#  # #### #  #     #    #####       #
#  #      #      ###           ##   #
#  #####           #   ##   #   #   #
#                                   #
##################^##################