######################################
#      # ###       ##    ###  #      #
# ### # #     ### #### #  ##  # ###  #
#   # # # ##### #       #  ## # # #  #
# ### #   ##    #######  # # #  # #  #
#   # # # #  ## #      # # #    # #  #
# ### # # # #   # #### # # # ## # #  #
#   # # # # # ###    # # # #         #
# # # # ### # # #### # # #   #########
#   # #   # # #   ^  # # # # #       #
# # # ## ## # ## ##### # # #   ##### #
#   #     # #    #   # # # #####     #
# #########  ##### # ##  #       #####
#         ##       #    ## ####### # E
######### ################ #       # #
#         #            #     ####### #
# ######### ###### # # # #####       #
#   #   #   #      # # ### # # #######
# #   #   # # #### # #               #
######################################